+ = = = = = = = = +
l p . . . . . . p l
l . * - * . * * . l
l . i ^ i . i i . l
l . * - * . * * . l
l p . . . v . . p l
l . * - * . * * . l
l . * - * . * * . l
l p . . . . . . p l
+ = = = = = = = = +