+ = = = = = = = = +
| p . . . . . . p |
| . * - * . * * . |
| . º ^ º . º º . |
| . * - * . * * . |
| p . . . p . . p |
| . * - * . * * . |
| . * - * . * * . |
| p . . . . . . p |
+ = = = = = = = = +